10
--.--.--.--.--.--.--.--.--.--
--.--.--.--.--.--.--.--.--.--
--.--.--.--.--.--.--.--.--.--
--.--.--.--.--.--.--.--.--.--
--.--.--.--.--.--.--.--.--.--
--.--.-B.-B.-B.--.--.--.-S.--
--.-B.-P.-P.-P.-B.--.-S.-W.S-
--.-B.-P.GB.-P.-B.--.--.-S.--
--.-B.-P.-P.-P.-B.--.--.--.--
A-.--.-B.-B.-B.--.--.--.--.--
